xxxxxxxxxxxxxxxx
x   xsx   xsx  x
x x     x     xx
x     x x   x  x
xx  x   v x    x
xsx x   x   x xx
x     x     x fx
x   x   x x s  x
x x     x     xx
x     x v   x  x
xx  x   s x    x
xxxxxxxxxxxxxxxx
